{
    ""
    "tileset": "tilemaps/APT_TILEMAP.png",
    "tileSize": 32,
    "mapWidth": 15,
    "mapHeight": 10,
    "tiles": [
        60, 60, 60, 60, 60, 60, 60, 60, 60, 60, 60, 60, 60, 60, 60,
        60, 60, 60, 60, 60, 60, 6, 7, 60, 60, 60, 60, 60, 60, 60,
        60, 0, 1, 1, 1, 1, 26, 27, 1, 1, 1, 1, 1, 2, 60,
        60, 20, 21, 21, 21, 21, 8, 9, 21, 21, 61, 62, 63, 22, 60,
        60, 40, 41, 41, 41, 41, 8, 9, 41, 41, 41, 41, 41, 42, 60,
        60, 23, 24, 24, 24, 24, 28, 29, 24, 31, 31, 31, 31, 32, 60,
        60, 23, 24, 24, 24, 24, 24, 24, 24, 31, 31, 31, 31, 32, 60,
        60, 23, 24, 24, 24, 24, 24, 13, 44, 16, 31, 31, 31, 32, 60,
        60, 43, 44, 65, 44, 44, 44, 45, 60, 50, 51, 51, 51, 52, 60,
        60, 60, 60, 60, 60, 60, 60, 60, 60, 60, 60, 60, 60, 60, 60
    ],
    "collisions": [
        1, 1, 1, 1, 1, 1, 1, 1, 1, 1, 1, 1, 1, 1, 1,
        1, 1, 1, 1, 1, 1, 1, 1, 1, 1, 1, 1, 1, 1, 1,
        1, 1, 1, 1, 1, 1, 1, 1, 1, 1, 1, 1, 1, 1, 1,
        1, 1, 1, 1, 1, 1, 0, 1, 1, 1, 1, 1, 1, 1, 1,
        1, 1, 1, 1, 1, 1, 0, 1, 1, 1, 1, 1, 1, 1, 1,
        1, 0, 0, 0, 0, 0, 0, 0, 0, 0, 0, 0, 0, 1, 1,
        1, 0, 0, 0, 0, 0, 0, 0, 0, 0, 0, 0, 0, 1, 1,
        1, 0, 0, 0, 0, 0, 0, 1, 1, 0, 0, 0, 0, 1, 1,
        1, 1, 1, 1, 1, 1, 1, 1, 1, 1, 1, 1, 1, 1, 1
    ]
}